{
	"number":10,
	"unlock":false,
	"color":6,
	"localisation":"candy ville",
	"tile":[[1,1,1,1,1,1,1,1,1],
			[1,1,1,1,1,1,1,1,1],
			[1,1,1,1,1,1,1,1,1],
			[-1,1,1,-2,-2,1,1,1,-1],
			[1,1,-2,-2,-2,-2,-2,1,1],
			[-2,-2,-2,-2,-1,-2,1,-2,-2],
			[-2,-2,-2,-2,-2,-2,1,-2,-2],
			[1,-2,-2,-2,-2,-2,1,-2,1],
			[1,-2,-2,-2,-2,-2,-2,-2,1]],
	"type":"GL",
	"target":{
			"or":100000,
			"moves":40,
			"argent":70000,
			"bronze":40000
			}
	}
