{
	"number":7,
	"unlock":false,
	"color":6,
	"localisation":"candy ville",
	"tile":[[1,1,1,1,1,1,1,1,1],
			[1,-2,-2,-2,-2,-2,-2,-2,1],
			[-2,-2,-2,-2,-2,-2,-2,-2,-2],
			[-2,-2,-2,-2,-2,-2,-2,-2,-2],
			[-2,-2,-2,-2,-2,-2,-2,-2,-2],
			[-2,-2,-2,-2,-2,-2,-2,-2,-2],
			[1,-2,-2,-2,-2,-2,-2,-2,1],
			[1,1,1,-2,-2,-2,1,1,1],
			[-1,1,1,1,1,1,1,1,-1]],
	"type":"GL",
	"target":{
			"or":85000,
			"moves":50,
			"argent":75000,
			"bronze":60000
			}
	}
