{
	"number":8,
	"unlock":false,
	"color":6,
	"localisation":"candy ville",
	"tile":[[1,1,1,1,-1,1,1,1,1],
			[1,-2,-2,1,-1,1,-2,-2,1],
			[1,-2,-2,1,1,1,-2,-2,1],
			[1,1,1,1,1,1,1,1,1],
			[1,1,1,1,1,1,1,1,1],
			[1,1,1,-2,-2,-2,1,1,1],
			[1,1,1,-2,-2,-2,1,1,1],
			[-1,1,1,-2,-2,-2,1,1,-1],
			[-1,-1,1,1,1,1,1,-1,-1]],
	"type":"GL",
	"target":{
			"or":45000,
			"moves":20,
			"argent":30000,
			"bronze":20000
			}
	}
